2222222222222222222222222
2000200000014150000020002
2000000000011100000000002
2010000010000000100000102
2001000102202022010001002
2000121001100011001210002
2000010011120211100100002
2110000000011100000000112
2110000220022200220000112
2333113330033300333113332
2333113330033300333113332
2110000220022200220000112
2110000000011100000000112
2000010011120211100100002
2000121001100011001210002
2001000102202022010001002
2010000010000000100000102
2000000000011100000000002
2000200000617100000020002
2222222222222222222222222
